00S0000000000000000000
00#0T00000000t00000T00
00#000#####00000000000
00#000#000#000VWVWVW00
00#000#000#000WVWwWV00
00#000#000#000WVWWVW00
00#000#000#000VWVWWV00
00#0d0#000#00000000000
00#000#000#00000000000
00#####000###########B
00000000T0000000000000
0000000000000000000000