00S00000000000000000000000000
00#00000000000000000000000000
00#000#####000#####000#####00
00#000#000#000#000#000#000#00
00#000#000#000#000#000#000#00
00#000#000#000#000#000#000#00
00#000#000#000#000#000#000#00
00#000#000#000#000#000#000#00
00#000#000#000#000#000#000#00
00#000#000#000#000#000#000#00
00#000#000#000#000#000#000#00
00#000#000#000#000#000#000#00
00#000#000#000#000#000#000#00
00#000#000#000#000#000#000#00
00#000#000#000#000#000#000#00
00#000#000#000#000#000#000#00
00#####000#####000#####000#00
00000000000000000000000000#00
00000000000000000000000000B00