00S00000000000000000000000000
00#0T000000000000000T00000000
00#000#####000#####000#####00
00#000#000#000#000#000#000#00
00#000#000#000#000#000#000#00
00#000#000#000#000#000#000#00
00#000#000#000#000#000#000#00
00#000#000#000#0T0#000#000#00
00#000#000#000#000#000#000#00
00#000#000#000#000#000#000#00
00#000#000#000#000#000#000#00
00#000#000#000#000#000#000#00
00#000#000#000#000#000#000#00
00#000#000#000#000#000#000#00
00#000#000#000#000#000#000#00
00#000#0T0#000#000#000#000#00
00#####000#####000#####000#00
000000000000000000000000T0#00
00000000000000000000000000B00