00S000000000000
00#0T00000000T0
00#000#####0000
00#000#000#0000
00#000#000#0000
00#000#000#0000
00#000#000#0000
00#000#000#0000
00#000#000#0000
00#####000####B
00000000T000000
000000000000000