000S0000
000#0000
00##0000
00#00000
00#####B
00000000